pct16,total,voters,count,votes,prop65_yes,yespct,prop65_no,nopct
CP1,Total,910,2,611,181,29.62%,430,70.38%
MB2,Total,121,2,82,37,45.12%,45,54.88%
MB3,Total,272,2,204,48,23.53%,156,76.47%
CP4,Total,946,2,712,155,21.77%,557,78.23%
CP5,Total,405,2,311,84,27.01%,227,72.99%
CP9,Total,341,2,237,75,31.65%,162,68.35%
MB6,Total,168,2,122,27,22.13%,95,77.87%
MB42,Total,204,2,153,50,32.68%,103,67.32%
MB8,Total,198,2,151,59,39.07%,92,60.93%
MB10,Total,205,2,142,47,33.10%,95,66.90%
MB43,Total,167,2,106,33,31.13%,73,68.87%
MB44,Total,178,2,124,54,43.55%,70,56.45%
MB45,Total,170,2,110,37,33.64%,73,66.36%
MB46,Total,250,2,175,61,34.86%,114,65.14%
CP7,Total,311,2,212,57,26.89%,155,73.11%
MB47,Total,142,2,81,35,43.21%,46,56.79%
MB48,Total,82,2,61,14,22.95%,47,77.05%
MB49,Total,116,2,81,18,22.22%,63,77.78%
MB50,Total,209,2,135,35,25.93%,100,74.07%
MB22,Total,96,2,70,20,28.57%,50,71.43%
MB32,Total,108,2,83,18,21.69%,65,78.31%
CP11,Total,888,2,678,158,23.30%,520,76.70%
CP12,Total,1243,2,953,236,24.76%,717,75.24%
CP13,Total,848,2,622,128,20.58%,494,79.42%
MB52,Total,0,2,4,0,0.00%,4,100.00%
MB53,Total,0,2,11,5,45.45%,6,54.55%
MB24,Total,53,2,35,3,8.57%,32,91.43%
MB14,Total,199,2,147,51,34.69%,96,65.31%
MB15,Total,237,2,180,37,20.56%,143,79.44%
MB31,Total,7,2,2,1,50.00%,1,50.00%
CP16,Total,484,2,365,63,17.26%,302,82.74%
MB33,Total,69,2,55,13,23.64%,42,76.36%
MB17,Total,231,2,184,34,18.48%,150,81.52%
MB25,Total,54,2,41,6,14.63%,35,85.37%
MB26,Total,90,2,74,21,28.38%,53,71.62%
CP18,Total,986,2,733,216,29.47%,517,70.53%
MB51,Total,163,2,85,37,43.53%,48,56.47%
CP19,Total,646,2,458,126,27.51%,332,72.49%
MB27,Total,69,2,32,13,40.63%,19,59.38%
CP20,Total,481,2,371,73,19.68%,298,80.32%
MB39,Total,165,2,119,26,21.85%,93,78.15%
MB40,Total,113,2,78,18,23.08%,60,76.92%
CP21,Total,355,2,233,63,27.04%,170,72.96%
MB36,Total,159,2,90,33,36.67%,57,63.33%
MB37,Total,238,2,147,47,31.97%,100,68.03%
CP23,Total,479,2,356,89,25.00%,267,75.00%
MB38,Total,81,2,46,16,34.78%,30,65.22%
MB34,Total,53,2,35,9,25.71%,26,74.29%
MB28,Total,67,2,52,11,21.15%,41,78.85%
MB29,Total,30,2,22,0,0.00%,22,100.00%
MB35,Total,1,2,0,0,-,0,-
MB41,Total,162,2,128,29,22.66%,99,77.34%
MB30,Total,57,2,54,14,25.93%,40,74.07%
